AP	AP
br	AP
SP	SP
pau	SP
sil	SP
a	a
i	i
u	u
e	e
o	o
N	N
ka	k a
ki	k i
ku	k u
ke	k e
ko	k o
ga	g a
gi	g i
gu	g u
ge	g e
go	g o
kya	ky a
kyi	ky i
kyu	ky u
kye	ky e
kyo	ky o
kwa	kw a
kwi	kw i
kwu	kw u
kwe	kw e
kwo	kw o
gya	gy a
gyi	gy i
gyu	gy u
gye	gy e
gyo	gy o
gwa	gw a
gwi	gw i
gwu	gw u
gwe	gw e
gwo	gw o
sa	s a
si	s i
su	s u
se	s e
so	s o
za	z a
zi	z i
zu	z u
ze	z e
zo	z o
sha	sh a
shi	sh i
shu	sh u
she	sh e
sho	sh o
ja	j a
ji	j i
ju	j u
je	j e
jo	j o
ta	t a
ti	t i
tu	t u
te	t e
to	t o
tya	ty a
tyi	ty i
tyu	ty u
tye	ty e
tyo	ty o
da	d a
di	d i
du	d u
de	d e
do	d o
dya	dy a
dyi	dy i
dyu	dy u
dye	dy e
dyo	dy o
cha	ch a
chi	ch i
chu	ch u
che	ch e
cho	ch o
tsa	ts a
tsi	ts i
tsu	ts u
tse	ts e
tso	ts o
na	n a
ni	n i
nu	n u
ne	n e
no	n o
nya	ny a
nyi	ny i
nyu	ny u
nye	ny e
nyo	ny o
ha	h a
hi	h i
hu	h u
he	h e
ho	h o
ba	b a
bi	b i
bu	b u
be	b e
bo	b o
pa	p a
pi	p i
pu	p u
pe	p e
po	p o
hya	hy a
hyi	hy i
hyu	hy u
hye	hy e
hyo	hy o
bya	by a
byi	by i
byu	by u
bye	by e
byo	by o
pya	py a
pyi	py i
pyu	py u
pye	py e
pyo	py o
fa	f a
fi	f i
fu	f u
fe	f e
fo	f o
ma	m a
mi	m i
mu	m u
me	m e
mo	m o
mya	my a
myi	my i
myu	my u
mye	my e
myo	my o
ya	y a
yi	y i
yu	y u
ye	y e
yo	y o
ra	r a
ri	r i
ru	r u
re	r e
ro	r o
rya	ry a
ryi	ry i
ryu	ry u
rye	ry e
ryo	ry o
wa	w a
wi	w i
wu	w u
we	w e
wo	w o
va	v a
vi	v i
vu	v u
ve	v e
vo	v o